###############
#             #
#  G    H     #
#             #
#    #        #
#       @     #
#             #
#       #     #
#             #
#             #
#             #
###############