##################################
#                                #
#                                #
#                                #
#                                #
#                                #
#                                #
#            #######             #
#            #GGGGG#             #
#            #GGGGG#             #
#            ### ###             #
#                                #
#                                #
#                                #
#                                #
#                                #
#                                #
#                                #
#                                #
#H@                              #
##################################