#################
#               #
#               #
#               #
#               #
#   #########   #
#   #GGGGGGG#   #
#   #GGGGGGG#   #
#   #### ####   #
#               #
#               #
#               #
#               #
#H@             #
#################