#################
#@      #       #
###     #   #   #
# #G#   #   # H #
# ###   #   #####
#       #       #
#               #
#               #
#      G        #
#        ########
#          G    #
#               #
#   G           #
#               #
#################
