#################
#               #
#               #
#               #
#               #
#               #
#               #
#       G       #
#      G#G      #
#     G###G     #
#    G#####G    #
#   G#######G   #
#  G#########G  #
#@G###########GH#
#################